6 0 0 0 0 7 9 9 9 9 9 9 9 9 9 9
6 0 0 0 0 0 5 5 5 5 5 5 5 5 5 2
6 0 0 0 0 0 0 0 0 0 0 0 0 0 0 7
6 0 8 8 8 8 0 0 0 0 0 0 0 0 0 7
6 7 9 9 9 9 6 0 0 0 0 0 0 0 0 7
6 7 9 9 9 9 6 0 0 0 0 0 0 0 0 7
6 0 5 5 5 5 0 0 0 0 0 0 0 0 0 7
6 0 0 0 0 0 0 0 0 0 0 0 0 0 0 7
6 0 0 0 0 0 0 0 0 0 0 0 0 0 0 7
3 8 8 8 8 8 8 8 8 8 8 8 8 8 8 4
9 9 9 9 9 9 9 9 9 9 9 9 9 9 9 9
1 5 5 5 5 5 5 5 5 5 5 5 5 5 5 2