4 4 4 4 4 4 4 4 4 4 4 4 4 4 4 4 4 4 4 4 4 4 4 4 4 4 4 4 4 4 4 4 4 4 4 4 4 4 4 4 4 4 4 4 4 4 4 4 4 4 
4 4 4 4 4 4 4 4 4 4 4 4 4 4 4 4 4 4 4 3 3 3 3 3 3 3 3 3 4 4 4 4 4 4 4 4 4 4 4 4 4 4 4 4 4 4 4 4 4 4
4 4 4 4 4 4 4 4 4 4 4 4 4 4 4 4 4 4 4 3 0 1 2 0 1 2 0 3 4 4 4 4 4 4 4 4 4 4 4 4 4 4 4 4 4 4 4 4 4 4
4 4 4 4 4 4 4 4 4 4 4 4 4 4 4 4 4 4 4 3 2 0 1 2 0 1 2 3 4 4 4 4 4 4 4 4 4 4 4 4 4 4 4 4 4 4 4 4 4 4
4 4 4 4 4 4 4 4 4 4 4 4 4 4 4 4 4 4 4 3 0 1 2 0 1 2 0 3 4 4 4 4 4 4 4 4 4 4 4 4 4 4 4 4 4 4 4 4 4 4
4 4 4 4 4 4 4 3 3 3 3 3 3 3 4 4 4 4 4 3 2 0 1 2 0 1 2 3 4 4 4 4 4 4 4 4 4 4 4 4 4 4 4 4 4 4 4 4 4 4
4 4 4 4 4 4 4 3 0 2 1 0 2 3 4 4 4 4 4 3 3 3 5 0 1 5 3 3 4 4 4 4 4 4 4 4 4 4 4 4 4 4 4 4 4 4 4 4 4 4
4 4 4 4 4 4 4 3 2 1 0 2 1 3 4 4 4 4 4 3 3 3 5 2 0 5 3 3 4 4 4 4 4 3 3 3 3 3 3 3 3 3 3 4 4 4 4 4 4 4
4 4 4 4 4 4 4 3 0 2 1 0 2 3 4 4 4 4 4 4 4 4 4 0 1 4 4 4 4 4 4 4 4 3 0 2 1 0 2 1 0 2 3 4 4 4 4 4 4 4
4 4 4 4 4 4 4 3 2 1 0 2 1 3 4 4 4 4 4 4 4 4 4 2 0 4 4 4 4 4 4 4 4 3 2 1 0 2 1 0 2 1 3 4 4 4 4 4 4 4
4 4 4 4 4 4 4 3 3 5 2 5 3 3 4 4 4 4 4 4 4 4 4 0 1 4 4 4 4 4 4 4 4 3 0 2 1 0 2 1 0 2 3 4 4 4 4 4 4 4
4 4 4 4 4 4 4 4 4 4 0 4 4 4 4 4 4 4 4 4 4 4 4 2 0 4 4 4 4 4 4 4 4 3 2 1 0 2 1 0 2 1 3 4 4 4 4 4 4 4
4 4 4 4 4 4 4 4 4 4 2 4 4 4 4 4 4 4 4 4 4 4 4 0 1 4 4 4 4 4 4 4 4 3 3 3 3 5 2 1 5 3 3 4 4 4 4 4 4 4
4 4 4 4 4 4 4 4 4 4 0 4 4 4 4 4 4 4 4 4 4 4 4 2 0 4 4 4 4 4 4 4 4 4 4 4 4 4 1 0 4 4 4 4 4 4 4 4 4 4
4 4 4 4 4 4 4 4 4 4 2 4 4 4 4 4 4 4 4 4 4 4 4 0 1 4 4 4 4 4 4 4 4 4 4 4 4 4 2 1 4 4 4 4 4 4 4 4 4 4
4 4 4 4 4 4 4 4 4 2 0 4 4 4 4 4 4 4 4 4 4 4 4 2 0 4 4 4 4 4 4 4 4 4 4 4 4 4 1 0 4 4 4 4 4 4 4 4 4 4
4 4 4 4 4 4 4 4 4 0 4 4 4 4 4 4 4 4 4 4 4 2 1 0 1 2 0 4 4 4 4 4 4 4 4 4 4 4 2 1 4 4 4 4 4 4 4 4 4 4
4 4 4 4 4 4 4 4 4 2 4 4 4 1 2 0 1 2 0 1 2 0 2 1 0 1 2 1 0 2 1 0 1 2 0 1 2 0 1 0 4 4 4 4 4 4 4 4 4 4
4 4 4 4 4 4 4 4 4 0 4 4 4 2 4 4 4 4 4 4 4 1 0 2 1 2 0 2 0 1 0 2 1 0 2 1 0 1 2 1 4 4 4 4 4 4 4 4 4 4
4 4 4 4 4 4 4 4 4 2 4 4 4 1 4 4 4 4 4 4 4 4 4 1 2 1 4 4 4 4 4 4 4 4 4 4 4 4 1 0 4 4 4 4 4 4 4 4 4 4
4 4 4 4 4 4 4 4 4 0 4 4 4 1 4 4 4 4 4 4 4 4 4 2 1 4 4 4 4 4 4 4 4 4 4 4 4 4 0 1 4 4 4 4 4 4 4 4 4 4
4 4 4 4 4 4 4 4 4 2 4 4 4 2 4 4 4 4 4 4 4 4 4 1 2 4 4 4 4 4 4 4 4 4 4 4 4 4 1 0 4 4 4 4 4 4 4 4 4 4
4 4 4 4 4 4 4 4 4 0 4 4 4 1 4 4 4 4 4 4 4 4 4 2 1 4 4 4 4 4 4 4 4 4 4 4 4 4 0 1 4 4 4 4 4 4 4 4 4 4
4 4 4 4 4 4 4 4 4 2 4 4 4 2 4 4 4 4 4 4 4 4 4 1 2 4 4 4 4 4 4 4 4 4 4 4 4 4 1 0 4 4 4 4 4 4 4 4 4 4
4 4 4 4 4 4 4 4 4 0 4 4 4 1 4 4 4 4 4 4 4 4 4 2 1 4 4 4 4 4 4 4 4 4 4 4 4 4 0 1 4 4 4 4 4 4 4 4 4 4
4 4 4 4 4 4 4 3 3 2 3 3 3 2 3 4 4 4 4 4 4 4 4 1 2 4 4 4 4 4 4 4 4 4 3 3 3 3 1 0 3 3 3 4 4 4 4 4 4 4
4 4 4 4 4 4 4 3 2 1 0 2 1 0 3 4 4 4 4 4 4 4 4 2 1 4 4 4 4 4 4 4 4 4 3 0 2 1 0 2 1 0 3 4 4 4 4 4 4 4
4 4 4 4 4 4 4 3 0 2 1 0 2 1 3 4 4 4 4 4 4 4 4 1 2 4 4 4 4 4 4 4 4 4 3 1 0 2 1 0 2 1 3 4 4 4 4 4 4 4
4 4 4 4 4 4 4 3 2 1 0 2 1 0 3 4 4 4 4 4 4 4 4 2 1 4 4 4 4 4 4 4 4 4 3 0 2 1 0 2 1 0 3 4 4 4 4 4 4 4
4 4 4 4 4 4 4 3 1 0 2 1 0 2 3 4 4 4 4 4 4 4 4 1 2 4 4 4 4 4 4 4 4 4 3 1 0 2 1 0 2 1 3 4 4 4 4 4 4 4
4 4 4 4 4 4 4 3 2 1 0 2 1 0 3 4 4 4 4 4 4 4 1 2 1 4 4 4 4 4 4 4 4 4 3 0 2 1 0 2 1 0 3 4 4 4 4 4 4 4
4 4 4 4 4 4 4 3 3 3 3 3 3 3 3 4 4 4 3 3 3 3 2 1 2 3 4 4 4 4 4 4 4 4 3 3 3 5 1 0 5 3 3 4 4 4 4 4 4 4
4 4 4 4 4 4 4 4 4 4 4 4 4 4 4 4 4 4 3 0 1 2 0 1 3 3 4 4 4 4 4 4 4 4 3 3 3 3 0 2 3 3 3 4 4 4 4 4 4 4
4 4 4 4 4 4 4 4 4 4 4 4 4 4 4 4 4 4 3 1 2 0 1 2 3 4 4 4 4 4 4 4 4 4 3 3 3 5 1 0 5 3 3 4 4 4 4 4 4 4
4 4 4 4 4 4 4 4 4 4 4 4 4 4 4 4 4 4 3 0 1 2 0 1 3 4 4 4 4 4 4 4 4 4 3 2 1 0 2 1 0 2 3 4 4 4 4 4 4 4
4 4 4 4 4 4 4 4 4 4 4 4 4 4 4 4 4 4 3 1 2 0 1 2 3 4 4 4 4 4 4 4 4 4 3 1 2 0 1 2 0 1 3 4 4 4 4 4 4 4
4 4 4 4 4 4 4 4 4 4 4 4 4 4 4 4 4 4 3 0 1 2 0 1 3 4 4 4 4 4 4 4 4 4 3 0 2 1 0 2 1 0 3 4 4 4 4 4 4 4
4 4 4 4 4 4 4 4 4 4 4 4 4 4 4 4 4 4 3 1 2 0 1 2 3 4 4 4 4 4 4 4 4 4 3 1 2 0 1 2 0 1 3 4 4 4 4 4 4 4
4 4 4 4 4 4 4 4 4 4 4 4 4 4 4 4 4 4 3 0 1 2 0 1 3 4 4 4 4 4 4 4 4 4 3 0 2 1 0 2 1 0 3 4 4 4 4 4 4 4
4 4 4 4 4 4 4 4 4 4 4 4 4 4 4 4 4 4 3 1 2 0 1 2 3 4 4 4 4 4 4 4 4 4 3 1 2 0 1 2 0 1 3 4 4 4 4 4 4 4
4 4 4 4 4 4 4 4 4 4 4 4 4 4 4 4 4 4 3 0 1 2 0 1 3 4 4 4 4 4 4 4 4 4 3 0 2 1 0 2 1 0 3 4 4 4 4 4 4 4
4 4 4 4 4 4 4 4 4 4 4 4 4 4 4 4 4 4 3 3 3 3 3 3 3 4 4 4 4 4 4 4 4 4 3 1 2 0 1 2 0 1 3 4 4 4 4 4 4 4
4 4 4 4 4 4 4 4 4 4 4 4 4 4 4 4 4 4 4 4 4 4 4 4 4 4 4 4 4 4 4 4 4 4 3 0 2 1 0 2 1 0 3 4 4 4 4 4 4 4
4 4 4 4 4 4 4 4 4 4 4 4 4 4 4 4 4 4 4 4 4 4 4 4 4 4 4 4 4 4 4 4 4 4 3 3 3 3 3 3 3 3 3 4 4 4 4 4 4 4
4 4 4 4 4 4 4 4 4 4 4 4 4 4 4 4 4 4 4 4 4 4 4 4 4 4 4 4 4 4 4 4 4 4 4 4 4 4 4 4 4 4 4 4 4 4 4 4 4 4 
4 4 4 4 4 4 4 4 4 4 4 4 4 4 4 4 4 4 4 4 4 4 4 4 4 4 4 4 4 4 4 4 4 4 4 4 4 4 4 4 4 4 4 4 4 4 4 4 4 4
4 4 4 4 4 4 4 4 4 4 4 4 4 4 4 4 4 4 4 4 4 4 4 4 4 4 4 4 4 4 4 4 4 4 4 4 4 4 4 4 4 4 4 4 4 4 4 4 4 4 
4 4 4 4 4 4 4 4 4 4 4 4 4 4 4 4 4 4 4 4 4 4 4 4 4 4 4 4 4 4 4 4 4 4 4 4 4 4 4 4 4 4 4 4 4 4 4 4 4 4
4 4 4 4 4 4 4 4 4 4 4 4 4 4 4 4 4 4 4 4 4 4 4 4 4 4 4 4 4 4 4 4 4 4 4 4 4 4 4 4 4 4 4 4 4 4 4 4 4 4 
4 4 4 4 4 4 4 4 4 4 4 4 4 4 4 4 4 4 4 4 4 4 4 4 4 4 4 4 4 4 4 4 4 4 4 4 4 4 4 4 4 4 4 4 4 4 4 4 4 4